111111111
1P0C00C01
1001E0001
111111111